  _                 _                                                             
 | |               | |                                                            
 | |__   ___   ___ | | ________ _ __ ___   ___  _ __ ___ ______ ___ ___  _ __ ___ 
 | '_ \ / _ \ / _ \| |/ /______| '__/ _ \ / _ \| '_ ` _ \______/ __/ _ \| '__/ _ \
 | |_) | (_) | (_) |   <       | | | (_) | (_) | | | | | |    | (_| (_) | | |  __/
 |_.__/ \___/ \___/|_|\_\      |_|  \___/ \___/|_| |_| |_|     \___\___/|_|  \___|
                                                                                  
                                                                                  
